1111111111111111111
1000000001000000001
1511011101011101151
1011011101011101101
1000000000000000001
1011010111110101101
1000010001000100001
1111011101011101111
7771010000000101777
1111010117110101111
0000000172710000000
1111010111110101111
7771010003000101777
1111010111110101111
1000000001000000001
1011011101011101101
1501000000000001051
1101010111110101011
1000010001000100001
1011111101011111101
1000000000000000001
1111111111111111111