1100001010
0001111011
0000000000
1101110110
0101200010
1101110011
0003000110
0001000000
1101011110
0001001000