1010017100101
1010011100101
1000003000001
1100111110011
0000172710000
1100111110011
1000000000001
1010011100101
1010017100101