110000000001001000111111000001
010000010001001000000000000001
010000010011111111110000111111
000000010000001000000010000001
000000010000001000000010000000
011111010000001000000010000000
000001000111001000000000000111
000001000100001000000000010000
101101111100001000010000010000
101001000000001000010000010011
101001000000000000010000011001
101111000110000000010000010001
100000000101011100010000010001
100011100000000100000000011111
100001000000000000000000000000
100001000011111100001001110000
100001000010000000001000000100
000000000011111100001000000100
000000000000011000001000001110