1100001010
0001111011
0000000000
1101110110
0101000010
1101110011
0000000110
0001000000
1101011110
0001001000